type octile
height 4
width 4
map
TTTT
T..T
T..T
TTTT