type octile
height 30
width 30
map
..TTTTTTTTTTTTTTTTTTTTTTTTTTTT
....T.T......................T
T.TTT.TTTTTTTTTTTTT.TTTTTTTTTT
T.T...T...T.T.........T......T
T.TTT.TTT.T.T.TTTTTTTTTTT.T.TT
T...T.........T.T...T...T.T..T
T.TTTTTTT.TTTTT.T.T.T.T.T.T.TT
T...T.T.T.........T.T.T...T.TT
TTT.T.T.TTTTT.TTTTTTTTTTT.TTTT
T.T...T.T.T...T.....T.....T..T
T.T.TTT.T.TTT.TTT.TTT.TTT.TTTT
T.......T.T.......T.T...T.T.TT
TTTTT.TTT.TTTTT.T.T.T.TTT.T.TT
T.T.........T.T.T.....T...T.TT
T.TTTTT.TTTTT.TTTTTTT.TTT.T.TT
T.T.......T.....T.......T.T..T
T.T.TTT.T.TTT.T.TTT.TTTTTTTTTT
T...T.T.T...T.T.....T.T.T.T..T
TTTTT.TTTTT.TTT.TTTTT.T.T.TTTT
T.......T.....T.....T.T.T....T
TTT.TTT.TTTTT.TTTTT.T.T.T.TTTT
T.T.T...T.............T.....TT
T.T.T.TTT.TTT.TTTTTTTTT.TTT.TT
T.T.T.......T.T...T...T.T....T
T.T.TTT.TTT.TTT.TTTTT.TTT.TTTT
T.....T.T...T.T...T...T.....TT
TTT.TTTTTTT.T.T.TTTTT.T.T.TTTT
T.....T.T.......T.T.T...T.T.TT
TTT.TTT.T.TTTTT.T.T.T.TTTTT.TT
TTTTTTTTTTTTTTTTTTTTTTTTTTTTTT